WWWWWWWWWWWWWWW
W-------------W
W---------?---W
W-------------W
W*-----------!W
WXXXX---XXXXXXW
WXXXXHHHXXXXXXW
WWWWWWWWWWWWWWW
